14
**************
*S           *
** ********* *
*        *   *
* ****** * * *
* *    * * * *
* * ** *   * *
* * *  * E * *
* * * **   * *
* * *    * * *
*E* ****** * *
* *     F    *
*   **********
**************