12
************
*S *       *
** *** *****
*       *  *
* ***** *  *
* *   * *  *
* * * * *  *
* * *   *  *
* * *****  *
* *     *  *
* *** EF   *
************